############
#OX        #
#   P      #
#          #
#          #
#  OX      #
#          #
#          #
#       X  #
#         O#
############
